XXXXXXXXXXXXXXXXXXX
X|XX..............X
X....X.X.X.X.X.X|.X
XXX..X.........XX.X
X...XXXXX.XXXX....X
X.XXX...........X.X
X.  X.XXX XXX.X.X.X
X.X X.XMM MMX... .X
X.X|X. MM MMXX XX.X
X.XXX.XXX XXX| X..X
X.X...X|| ||XXXX.XX
X.X.XXXXXXXXX   ..X
X...           XX.X
XXX XX X X X X XX.X
X    P P P P P   .X
X  XXX XX XX XXX .X
X|XX.   X X   ....X
X..X.XXXX XXXX.XX.X
XX.X...........X..X
X..X XXXX.XX X.X.XX
X.       .   X...|X
XXXXXXXXXXXXXXXXXXX
